###################################
# Syntax Coloring Map AUDIO
###################################

###################################
# Datatypes (KEYWORD1)
###################################

DAISY	KEYWORD1
DaisyDuinoDevice	KEYWORD1
DaisyDuinoSampleRate	KEYWORD1
DaisyHardware		KEYWORD1

AdEnv	KEYWORD1
Adsr	KEYWORD1
Allpass	KEYWORD1
AnalogDassDrum	KEYWORD1
AnalogSnareDrum	KEYWORD1
Atone	KEYWORD1
Autowah	KEYWORD1
Balance	KEYWORD1
Biquad	KEYWORD1
Bitcrush	KEYWORD1
BlOsc	KEYWORD1
Chorus	KEYWORD1
ClockedNoise	KEYWORD1
Comb	KEYWORD1
Compressor	KEYWORD1
Crossfade	KEYWORD1
DcBlock		KEYWORD1
Decimator	KEYWORD1
DelayLine	KEYWORD1
Drip	KEYWORD1
Dust	KEYWORD1
Flanger	KEYWORD1
Fm2	KEYWORD1
Fold	KEYWORD1
FormantOscillator	KEYWORD1
FractalNoise	KEYWORD1
GrainletOscillator	KEYWORD1
HarmonicOscillator	KEYWORD1
HiHat	KEYWORD1
Jitter	KEYWORD1
Limiter	KEYWORD1
Line	KEYWORD1
Maytrig	KEYWORD1
Metro	KEYWORD1
ModalVoice	KEYWORD1
Mode	KEYWORD1
MoogLadder	KEYWORD1
NlFilt	KEYWORD1
Oscillator	KEYWORD1
OscillatorBank	KEYWORD1
Overdrive	KEYWORD1
Particle	KEYWORD1
Phasor	KEYWORD1
Port	KEYWORD1
Pitchshifter	KEYWORD1
PolyPluck	KEYWORD1
Pluck	KEYWORD1
Resonator	KEYWORD1
ReverbSc	KEYWORD1
SampleHold	KEYWORD1
SampleRateReducer	KEYWORD1
SmoothRandom	KEYWORD1
StringOsc	KEYWORD1
StringVoice	KEYWORD1
Svf	KEYWORD1
SynthBassDrum	KEYWORD1
SynthSnareDrum	KEYWORD1
Tone	KEYWORD1
Tremolo	KEYWORD1
VariableSawOscillator	KEYWORD1
VariableShapeOscillator	KEYWORD1
Vosim	KEYWORD1
WhiteNoise	KEYWORD1
ZOscillator	KEYWORD1

encoder		KEYWORD1
leds		KEYWORD1
buttons		KEYWORD1
gateIns		KEYWORD1
controle	KEYWORD1

Encoder		KEYWORD1
Led		KEYWORD1
Switch		KEYWORD1
GateIn		KEYWORD1
AnalogControl	KEYWORD1

###################################
# Methods and Functions (KEYWORD2)
###################################

init	KEYWORD2
begin	KEYWORD2
end	KEYWORD2

Init	KEYWORD2
Process	KEYWORD2
SetFreq	KEYWORD2
SetAmp	KEYWORD2

ProcessAllControls	KEYWORD2
ProcessAnalogControls	KEYWORD2
ProcessDigitalControls	KEYWORD2

Trig	KEYWORD2
State	KEYWORD2
Debounce	KEYWORD2
DebounceControls	KEYWORD2
Increment	KEYWORD2
RisingEdge	KEYWORD2
FallingEdge	KEYWORD2
Pressed		KEYWORD2
TimeHeldMs	KEYWORD2
Set		KEYWORD2
DebounceControls	KEYWORD2

SetRingLed	KEYWORD2
SetFootswitchLed	KEYWORD2
SetKeyboardLed	KEYWORD2
SetKnobLed	KEYWORD2
ClearLeds	KEYWORD2
UpdateLeds	KEYWORD2
GetKnobValue	KEYWORD2
KeyboardState	KEYWORD2
KeyboardRisingEdge	KEYWORD2
KeyboardFallingEdge	KEYWORD2

get_samplerate	KEYWORD2
get_callbackrate	KEYWORD2
get_blocksize	KEYWORD2
StartAudio	KEYWORD2
ChangeAudioCallback	KEYWORD2
StopAudio	KEYWORD2
SetAudioSampleRate	KEYWORD2
AudioSampleRate	KEYWORD2
SetAudioBlockSize	KEYWORD2
AudioBlockSize	KEYWORD2
AudioCallbackRate	KEYWORD2

mtof		KEYWORD2
DSY_CLAMP		KEYWORD2
fmax			KEYWORD2
fmin			KEYWORD2
fclamp			KEYWORD2
fastpower		KEYWORD2
fastroot		KEYWORD2
fonepole		KEYWORD2
soft_saturate		KEYWORD2

###################################
# Constants (LITERAL1)
###################################
PI_F			LITERAL1
TWOPI_F			LITERAL1
HALFPI_F		LITERAL1

AUDIO_SR_8K	LITERAL1
AUDIO_SR_16K	LITERAL1
AUDIO_SR_32K	LITERAL1
AUDIO_SR_48K	LITERAL1
AUDIO_SR_96K	LITERAL1

PIN_POD_POT_1	LITERAL1
PIN_POD_POT_2	LITERAL1
POD_NUM_POTS	LITERAL1
PIN_POD_SWITCH_1	LITERAL1
PIN_POD_SWITCH_2	LITERAL1
POD_NUM_SWITCHES	LITERAL1
PIN_POD_LED_1_RED	LITERAL1
PIN_POD_LED_1_GREEN	LITERAL1
PIN_POD_LED_1_BLUE	LITERAL1
PIN_POD_LED_2_RED	LITERAL1
PIN_POD_LED_2_GREEN	LITERAL1
PIN_POD_LED_2_BLUE	LITERAL1
POD_NUM_LEDS		LITERAL1
PIN_POD_ENC_A		LITERAL1
PIN_POD_ENC_B		LITERAL1
PIN_POD_ENC_CLICK	LITERAL1

PIN_PATCH_ENC_CLICK	LITERAL1
PIN_PATCH_ENC_B	LITERAL1
PIN_PATCH_ENC_A	LITERAL1
PIN_OLED_DC	LITERAL1
PIN_OLED_RESET	LITERAL1
PIN_PATCH_MIDI_OUT	LITERAL1
PIN_PATCH_MIDI_IN	LITERAL1
PIN_PATCH_GATE_OUT	LITERAL1
PIN_PATCH_GATE_IN_1	LITERAL1
PIN_PATCH_GATE_IN_2	LITERAL1
PIN_PATCH_CTRL_1	LITERAL1
PIN_PATCH_CTRL_2	LITERAL1
PIN_PATCH_CTRL_3	LITERAL1
PIN_PATCH_CTRL_4	LITERAL1
PIN_PATCH_CV_1	LITERAL1
PIN_PATCH_CV_2	LITERAL1

PIN_PETAL_SWITCH_1	LITERAL1
PIN_PETAL_SWITCH_2	LITERAL1
PIN_PETAL_SWITCH_3	LITERAL1
PIN_PETAL_SWITCH_4	LITERAL1
PIN_PETAL_SWITCH_5	LITERAL1
PIN_PETAL_SWITCH_6	LITERAL1
PIN_PETAL_SWITCH_7	LITERAL1
PIN_PETAL_ENC_A	LITERAL1
PIN_PETAL_ENC_B	LITERAL1
PIN_PETAL_ENC_CLICK	LITERAL1
PIN_PETAL_EXPRESSION	LITERAL1
PIN_PETAL_POT_1	LITERAL1
PIN_PETAL_POT_2	LITERAL1
PIN_PETAL_POT_3	LITERAL1
PIN_PETAL_POT_4	LITERAL1
PIN_PETAL_POT_5	LITERAL1
PIN_PETAL_POT_6	LITERAL1
PIN_PETAL_I2C1_SDA	LITERAL1
PIN_PETAL_I2C1_SCL	LITERAL1

PIN_FIELD_GATE_IN	LITERAL1
PIN_FIELD_SPI_CS	LITERAL1
PIN_FIELD_SPI_SCK	LITERAL1
PIN_FIELD_OLED_CMD	LITERAL1
PIN_FIELD_SPI_MOSI	LITERAL1
PIN_FIELD_I2C_SCL	LITERAL1
PIN_FIELD_I2C_SDA	LITERAL1
PIN_FIELD_MIDI_OUT	LITERAL1
PIN_FIELD_MIDI_IN	LITERAL1
PIN_FIELD_GATE_OUT	LITERAL1
PIN_FIELD_ADC_POT_MUX	LITERAL1
PIN_FIELD_ADC_CV_1	LITERAL1
PIN_FIELD_ADC_CV_2	LITERAL1
PIN_FIELD_MUX_SEL_2	LITERAL1
PIN_FIELD_MUX_SEL_1	LITERAL
PIN_FIELD_MUX_SEL_0	LITERAL1
PIN_FIELD_CD4021_D1	LITERAL1
PIN_FIELD_CD4021_CS	LITERAL1
PIN_FIELD_CD4021_CLK	LITERAL1
PIN_FIELD_SWITCH_2	LITERAL1
PIN_FIELD_SWITCH_1	LITERAL1
PIN_FIELD_DAC_2	LITERAL1
PIN_FIELD_DAC_1	LITERAL1
PIN_FIELD_ADC_CV_4	LITERAL1
PIN_FIELD_ADC_CV_3	LITERAL1

PIN_PATCH_SM_CV_1	LITERAL1
PIN_PATCH_SM_CV_2	LITERAL1
PIN_PATCH_SM_CV_3	LITERAL1
PIN_PATCH_SM_CV_4	LITERAL1
PIN_PATCH_SM_CV_5	LITERAL1
PIN_PATCH_SM_CV_6	LITERAL1
PIN_PATCH_SM_CV_7	LITERAL1
PIN_PATCH_SM_CV_8	LITERAL1
PIN_PATCH_SM_ADC_9	LITERAL1
PIN_PATCH_SM_ADC_10	LITERAL1
PIN_PATCH_SM_ADC_11	LITERAL1
PIN_PATCH_SM_ADC_12	LITERAL1
PIN_PATCH_SM_CV_OUT_1	LITERAL1
PIN_PATCH_SM_CV_OUT_2	LITERAL1
PIN_PATCH_SM_GATE_IN_1	LITERAL1
PIN_PATCH_SM_GATE_IN_2	LITERAL1
PIN_PATCH_SM_GATE_OUT_1	LITERAL1
PIN_PATCH_SM_GATE_OUT_2	LITERAL1
PIN_PATCH_SM_SPI_SCK	LITERAL1
PIN_PATCH_SM_SPI_CS	LITERAL1
PIN_PATCH_SM_SPI_MOSI	LITERAL1
PIN_PATCH_SM_SPI_MISO	LITERAL1
PIN_PATCH_SM_I2C_SCL	LITERAL1
PIN_PATCH_SM_I2C_SDA	LITERAL1
PIN_PATCH_USB_DM	LITERAL1
PIN_PATCH_USB_DP	LITERAL1
PIN_PATCH_SM_SDMMC_D3	LITERAL1
PIN_PATCH_SM_SDMMC_D2	LITERAL1
PIN_PATCH_SM_SDMMC_D1	LITERAL1
PIN_PATCH_SM_SDMMC_D0	LITERAL1
PIN_PATCH_SM_SDMMC_CLK	LITERAL1
PIN_PATCH_SM_SDMMC_CMD	LITERAL1
PIN_PATCH_SM_A2	LITERAL1
PIN_PATCH_SM_A3	LITERAL1
PIN_PATCH_SM_A8	LITERAL1
PIN_PATCH_SM_A9	LITERAL1
PIN_PATCH_SM_B5	LITERAL1
PIN_PATCH_SM_B6	LITERAL1
PIN_PATCH_SM_B7	LITERAL1
PIN_PATCH_SM_B8	LITERAL1
PIN_PATCH_SM_B9	LITERAL1
PIN_PATCH_SM_B10	LITERAL1
PIN_PATCH_SM_C1	LITERAL1
PIN_PATCH_SM_C2	LITERAL1
PIN_PATCH_SM_C3	LITERAL1
PIN_PATCH_SM_C4	LITERAL1
PIN_PATCH_SM_C5	LITERAL1
PIN_PATCH_SM_C6	LITERAL1
PIN_PATCH_SM_C7	LITERAL1
PIN_PATCH_SM_C8	LITERAL1
PIN_PATCH_SM_C9	LITERAL1
PIN_PATCH_SM_C10	LITERAL1
PIN_PATCH_SM_D1	LITERAL1
PIN_PATCH_SM_D2	LITERAL1
PIN_PATCH_SM_D3	LITERAL1
PIN_PATCH_SM_D4	LITERAL1
PIN_PATCH_SM_D5	LITERAL1
PIN_PATCH_SM_D6	LITERAL1
PIN_PATCH_SM_D7	LITERAL1
PIN_PATCH_SM_D8	LITERAL1
PIN_PATCH_SM_D9	LITERAL1
PIN_PATCH_SM_D10	LITERAL1

DAISY_SEED  LITERAL1
DAISY_PATCH LITERAL1
DAISY_POD   LITERAL1
DAISY_PETAL LITERAL1
DAISY_FIELD LITERAL1
DAISY_PATCH_SM  LITERAL1